신과함께: 신과함께-죄와 벌, 신과함께-인과 연
마블: 어벤져스:엔드게임, 어벤져스:인피니티 워, 어벤져스:에이지 오브 울트론, 아이언맨 3, 캡틴 아메리카: 시빌 워, 스파이더맨: 파 프롬 홈, 스파이더맨: 노 웨이 홈, 스파이더맨: 홈 커밍, 어벤져스, 닥터 스트레인지: 대혼돈의 멀티버스, 캡틴 마블, 닥터 스트레인지, 블랙 팬서, 어메이징 스파이더맨, 스파이더맨 3, 아이언맨 2, 아이언맨, 어메이징 스파이더맨2, 캡틴 아메리카: 윈터 솔져, 베놈, 데드 풀2, 
겨울왕국: 겨울왕국 2,겨울왕국
아바타: 아바타, 아바타: 물의 길
알라딘? 라이온킹? 
부산행:부산행
탑건: 매버릭
트랜스포머: 트랜스포머 3, 트랜스포머, 트랜스포머: 패자의 역습, 트랜스포머: 사라진 시대
미션임파서블: 미션임파서블:고스트프로토콜, 미션 임파서블: 폴아웃, 미션 임파서블: 로그네이션, 미션 임파서블 3
공조: 공조2: 인터네셔날
범죄도시: 범죄도시2, 범죄도시
배트맨: 다크 나이트 라이즈, 조커, 다크 나이트, 
킹스맨: 킹스맨: 시크릿 에이전트, 킹스맨: 골든 서클
타짜: 타짜, 타짜-신의 손, 
쥬라기 월드: 쥬라기 월드:폴른 킹덤, 쥬라기 월드
두사부일체: 투사부일체
쿵푸팬더: 쿵푸 팬더 2, 쿵푸 팬더, 쿵푸 팬더3, 
DC: 아쿠아맨 
해리포터: 신비한 동물사전, 해리포터와 죽음의 성물2, 해리 포터와 불사조 기사단, 해리 포터와 불의 잔, 
캐리비안의 해적: 캐리비안의 해적: 세상의 끝에서, 캐리비안의 해적: 망자의 함, 
가문의 영광: 가문의 위기, 
터미네이터: 터미네이터: 미래전쟁의 시작, 
강철비: 강철비
엑스맨: 엑스맨: 데이즈 오브 퓨처 패스트
공공의적: 강철중:공공의 적 1-1, 
박물관의 살아있다!: 박물관이 살아있다!, 
인디아나존스: 인디아나 존스 4: 크리스탈 해골의 왕국, 
미이라: 미이라 3: 황제의 무덤, 미이라, 
혹성탈출: 혹성탈출: 반격의 서막, 
매드 맥스: 매드 맥스: 분노의 도로, 
조선명탐정: 조선명탐정: 사라진 놉의 딸
분노의질주: 분노의질수: 더 익스트림, 분노의 질주: 홉스&쇼, 
킹콩: 킹콩